1,1 x,x x,x x,x x,x x,x x,x x,x x,x x,x
1,1 x,x x,x x,x x,x x,x x,x x,x x,x x,x
1,1 x,x x,x x,x x,x x,x x,x x,x x,x x,x
1,1 x,x x,x x,x x,x x,x x,x x,x x,x x,x
1,1 x,x x,x x,x x,x x,x x,x x,x x,x x,x
1,1 x,x x,x x,x x,x x,x x,x x,x x,x x,x
1,1 x,x x,x x,x 0,1 1,0 1,1 x,x x,x x,x
x,x x,x x,x x,x x,x x,x x,x x,x x,x x,x
0,0 0,0 0,0 0,0 0,0 0,0 0,0 0,0 0,0 0,0